000000000000000000000000000000000000000000000000000000
000000000000000000000000000000000000000000000000000000
000000000000000000000000000000000000000000000000000000
000000000000000000000000000000000000000000000000000000
000000022222000000000000000000000000000000000000000000
000000000000000000000000000000000000000000000000000000
220000000000000002200000022000000000000000000000000000
112222222222222221100002211200222200222222222222222222
111111111111111111100001111100111100111111100111111111
111111111111111111100000110000111110011111001111111111
111111111111111111100000100000111110000000001111111111
111111111111111111100000100000111111111111111111111111
111111111111111111100000000000111111111111111111111111